########################################
#                                      #
#                                      #
#                                      #
#           P                          #
#                                      #
#                                      #
#                                      #
#              #                       #
#              #                       #
#              #                       #
#              #                       #
#              #      #                #
#     ##########      #                #
#                     #                #
#                     #                #
#                     #########        #
#                                      #
#                                      #
#                                ###   #
#                                ###   #
########################################
########################################
