########################################
#                                      #
#                                      #
#                                      #
#                                      #
#                                      #
#                                      #
#              ##                      #
#              <#                      #
#              <#                      #
#              <#                      #
#     P        <#     #          ##    #
#              <#     #                #
#     ###########     #                #
#                     #                #
#                     #                #
#                     #########        #
##                    #vvv#            #
#>                                     #
#>                               ###   #
#>                               ###   #
###########^^^^^^#######################
########################################
